1111111111111111111111111
1000000000000000000000001
1000000000000000000000001
1010101010101000100010001
1000000000000001000000001
1010101010101011000000001
1000000000000M01000000001
1000000000000000000000001
1111111111111111111111111
